//MAP CONVERTED BY dmm2tgm.py THIS HEADER COMMENT PREVENTS RECONVERSION, DO NOT REMOVE
"a" = (
/turf/floor/dirt,
/area/caribbean)
"b" = (
/obj/covers/cement_wall,
/turf/floor/dirt,
/area/caribbean)
"c" = (
/obj/covers/cobblestone,
/turf/floor/dirt,
/area/caribbean)
"d" = (
/obj/effect/landmark{
	icon_state = "x3";
	name = "JoinLateFR"
	},
/obj/covers/cobblestone,
/turf/floor/grass,
/area/caribbean)
"g" = (
/obj/covers/cobblestone,
/obj/structure/railing,
/turf/floor/dirt,
/area/caribbean)
"h" = (
/turf/floor/beach/water/deep,
/area/caribbean)
"i" = (
/obj/structure/railing{
	dir = 4
	},
/turf/floor/beach/water/deep,
/area/caribbean)
"j" = (
/obj/structure/railing{
	dir = 8
	},
/turf/floor/beach/water,
/area/caribbean)
"k" = (
/turf/floor/beach/water,
/area/caribbean)
"l" = (
/obj/structure/railing{
	dir = 4
	},
/turf/floor/beach/water,
/area/caribbean)
"m" = (
/obj/structure/railing{
	dir = 8
	},
/turf/floor/beach/water/deep,
/area/caribbean)
"p" = (
/turf/floor/beach/water/deep,
/area/caribbean/island{
	base_turf = /turf/floor/dirt;
	name = "Castle"
	})
"q" = (
/obj/covers/cobblestone,
/obj/effect/floor_decal/dirtwall{
	icon_state = "dirt_wall";
	dir = 1
	},
/obj/effect/floor_decal/dirtwall{
	icon_state = "dirt_wall";
	dir = 8
	},
/turf/floor/beach/water/deep,
/area/caribbean/island{
	base_turf = /turf/floor/dirt;
	name = "Castle"
	})
"r" = (
/obj/covers/cobblestone,
/obj/item/weapon/gun/projectile/automatic/stationary/vickers{
	icon_state = "vickers";
	dir = 1
	},
/obj/effect/floor_decal/dirtwall{
	icon_state = "dirt_wall";
	dir = 1
	},
/turf/floor/beach/water/deep,
/area/caribbean/island{
	base_turf = /turf/floor/dirt;
	name = "Castle"
	})
"s" = (
/obj/covers/cobblestone,
/obj/effect/floor_decal/dirtwall{
	icon_state = "dirt_wall";
	dir = 1
	},
/turf/floor/beach/water/deep,
/area/caribbean/island{
	base_turf = /turf/floor/dirt;
	name = "Castle"
	})
"t" = (
/obj/covers/cobblestone,
/obj/effect/floor_decal/dirtwall{
	icon_state = "dirt_wall";
	dir = 4
	},
/obj/effect/floor_decal/dirtwall{
	icon_state = "dirt_wall";
	dir = 1
	},
/turf/floor/beach/water/deep,
/area/caribbean/island{
	base_turf = /turf/floor/dirt;
	name = "Castle"
	})
"u" = (
/obj/covers/cobblestone,
/turf/floor/beach/water/deep,
/area/caribbean/island{
	base_turf = /turf/floor/dirt;
	name = "Castle"
	})
"v" = (
/obj/covers/cobblestone,
/turf/floor/beach/water/deep,
/area/caribbean)
"x" = (
/obj/covers/cobblestone,
/obj/structure/closet/crate/ww1/ammo_vickers,
/turf/floor/beach/water/deep,
/area/caribbean/island{
	base_turf = /turf/floor/dirt;
	name = "Castle"
	})
"y" = (
/obj/covers/cobblestone,
/obj/item/weapon/gun/projectile/automatic/stationary/vickers{
	icon_state = "vickers";
	dir = 8
	},
/obj/effect/floor_decal/dirtwall{
	icon_state = "dirt_wall";
	dir = 8
	},
/turf/floor/beach/water/deep,
/area/caribbean/island{
	base_turf = /turf/floor/dirt;
	name = "Castle"
	})
"z" = (
/obj/covers/cobblestone,
/obj/item/weapon/gun/projectile/automatic/stationary/vickers{
	icon_state = "vickers";
	dir = 4
	},
/obj/effect/floor_decal/dirtwall{
	icon_state = "dirt_wall";
	dir = 4
	},
/turf/floor/beach/water/deep,
/area/caribbean/island{
	base_turf = /turf/floor/dirt;
	name = "Castle"
	})
"A" = (
/obj/covers/cobblestone,
/obj/effect/floor_decal/dirtwall{
	icon_state = "dirt_wall";
	dir = 8
	},
/obj/effect/floor_decal/dirtwall,
/turf/floor/beach/water/deep,
/area/caribbean/island{
	base_turf = /turf/floor/dirt;
	name = "Castle"
	})
"B" = (
/obj/covers/cobblestone,
/obj/effect/floor_decal/dirtwall,
/obj/effect/floor_decal/dirtwall{
	icon_state = "dirt_wall";
	dir = 4
	},
/turf/floor/beach/water/deep,
/area/caribbean/island{
	base_turf = /turf/floor/dirt;
	name = "Castle"
	})
"C" = (
/obj/covers/cobblestone,
/obj/effect/floor_decal/dirtwall,
/obj/effect/floor_decal/dirtwall{
	icon_state = "dirt_wall";
	dir = 8
	},
/turf/floor/beach/water/deep,
/area/caribbean/island{
	base_turf = /turf/floor/dirt;
	name = "Castle"
	})
"D" = (
/obj/covers/cobblestone,
/obj/item/weapon/gun/projectile/automatic/stationary/vickers,
/obj/effect/floor_decal/dirtwall,
/turf/floor/beach/water/deep,
/area/caribbean/island{
	base_turf = /turf/floor/dirt;
	name = "Castle"
	})
"E" = (
/obj/covers/cobblestone,
/obj/effect/floor_decal/dirtwall,
/turf/floor/beach/water/deep,
/area/caribbean/island{
	base_turf = /turf/floor/dirt;
	name = "Castle"
	})
"G" = (
/obj/structure/railing{
	dir = 8
	},
/obj/structure/railing,
/turf/floor/beach/water,
/area/caribbean)
"H" = (
/obj/structure/railing,
/turf/floor/beach/water,
/area/caribbean)
"I" = (
/obj/structure/railing{
	dir = 4
	},
/obj/structure/railing,
/turf/floor/beach/water,
/area/caribbean)
"J" = (
/obj/covers/cement_wall,
/turf/floor/beach/water,
/area/caribbean)
"K" = (
/obj/effect/landmark{
	name = "JoinLateRN"
	},
/obj/covers/cobblestone,
/turf/floor/dirt,
/area/caribbean)
"L" = (
/obj/effect/landmark{
	name = "JoinLateRN"
	},
/obj/covers/cobblestone,
/turf/floor/grass,
/area/caribbean)
"M" = (
/obj/covers/cobblestone,
/obj/covers/cobblestone,
/turf/floor/dirt,
/area/caribbean)

(1,1,1) = {"
b
b
b
b
b
b
b
h
h
h
h
h
h
h
h
h
h
h
h
h
h
h
h
h
h
h
h
h
h
h
h
h
h
h
h
h
h
h
h
h
h
h
h
h
h
h
h
h
h
h
h
h
h
h
b
b
b
b
b
b
"}
(2,1,1) = {"
b
c
c
c
c
b
b
h
h
h
h
h
h
h
h
h
h
h
h
h
h
h
h
h
h
h
h
h
h
h
h
h
h
h
h
h
h
h
h
h
h
h
h
h
h
h
h
h
h
h
h
h
h
h
b
c
c
c
c
b
"}
(3,1,1) = {"
b
c
c
c
c
b
b
h
h
h
h
h
h
h
h
h
h
h
h
h
h
h
h
h
h
h
h
h
h
h
h
h
h
h
h
h
h
h
h
h
h
h
h
h
h
h
h
h
h
h
h
h
h
h
b
c
c
c
c
b
"}
(4,1,1) = {"
b
c
c
c
c
b
b
h
h
h
h
h
h
h
h
h
h
h
h
h
h
h
h
h
h
h
h
h
h
h
h
h
h
h
h
h
h
h
h
h
h
h
h
h
h
h
h
h
h
h
h
h
h
h
b
c
K
K
L
b
"}
(5,1,1) = {"
b
c
c
c
c
b
b
h
h
h
h
h
h
h
h
h
h
h
h
h
h
h
h
h
h
h
h
h
h
h
h
h
h
h
h
h
h
h
h
h
h
h
h
h
h
h
h
h
h
h
h
h
h
h
b
c
L
L
L
b
"}
(6,1,1) = {"
b
d
d
d
c
b
b
h
h
h
h
h
h
h
h
h
h
h
h
h
h
h
h
h
h
h
h
h
h
h
h
h
h
h
h
h
h
h
h
h
h
h
h
h
h
h
h
h
h
h
h
h
h
h
b
c
c
c
c
b
"}
(7,1,1) = {"
b
d
d
d
c
b
b
h
h
h
h
h
h
h
h
h
h
h
h
h
h
h
h
h
h
h
h
h
h
h
h
h
h
h
h
h
h
h
h
h
h
h
h
h
h
h
h
h
h
h
h
h
h
h
b
c
c
c
c
b
"}
(8,1,1) = {"
b
c
c
c
c
b
b
h
h
h
h
h
h
h
h
h
h
h
h
h
h
h
h
h
h
h
h
h
h
h
h
h
h
h
h
h
h
h
h
h
h
h
h
h
h
h
h
h
h
h
h
h
h
h
b
c
c
c
c
b
"}
(9,1,1) = {"
b
c
c
c
c
b
b
h
h
h
h
h
h
h
h
h
h
h
h
h
h
h
h
h
h
h
h
h
h
h
h
h
h
h
h
h
h
h
h
h
h
h
h
h
h
h
h
h
h
h
h
h
k
k
b
c
c
c
c
b
"}
(10,1,1) = {"
b
b
c
b
b
b
b
i
i
i
i
i
i
i
i
i
i
i
i
i
i
i
i
i
i
i
i
i
i
i
i
i
i
i
i
i
i
i
i
i
i
i
i
i
i
i
i
i
i
i
i
i
l
J
b
b
b
b
c
b
"}
(11,1,1) = {"
c
c
c
c
c
c
c
c
c
c
c
c
c
c
c
c
c
c
c
c
c
c
c
c
c
c
c
c
c
c
c
c
c
c
c
c
c
c
c
c
c
c
c
c
c
c
c
c
c
c
c
c
c
c
c
c
a
a
a
a
"}
(12,1,1) = {"
c
c
c
c
c
c
c
c
c
c
c
c
c
c
c
c
c
c
c
c
c
c
c
c
c
c
c
c
c
c
c
c
c
c
c
c
c
c
c
c
c
c
c
c
c
c
c
c
c
c
c
c
c
c
c
c
a
a
a
a
"}
(13,1,1) = {"
c
c
c
c
c
c
c
c
c
c
c
c
c
c
c
c
c
c
c
c
c
c
c
c
c
c
c
c
c
c
c
c
c
c
c
c
c
c
c
c
c
c
c
c
c
c
c
c
c
c
c
c
c
c
c
c
a
a
a
a
"}
(14,1,1) = {"
c
c
c
c
c
c
c
c
c
c
c
c
c
c
c
c
c
c
c
c
c
c
c
c
c
c
c
c
c
c
c
c
c
c
c
c
c
c
c
c
c
c
c
c
c
c
c
c
c
c
c
c
c
c
c
c
a
a
a
a
"}
(15,1,1) = {"
c
c
c
c
c
c
c
c
c
c
c
c
c
c
c
c
c
c
c
c
c
c
c
c
c
c
c
c
c
c
c
c
c
c
c
c
c
c
c
c
c
c
c
c
c
c
c
c
c
c
c
c
c
c
c
c
a
a
a
a
"}
(16,1,1) = {"
c
c
c
c
c
c
c
c
c
c
c
c
c
c
c
c
c
c
c
c
c
c
c
c
c
c
c
c
c
c
c
c
c
c
c
c
c
c
c
c
c
c
c
c
c
c
c
c
c
c
c
c
b
b
c
c
a
a
a
a
"}
(17,1,1) = {"
c
c
c
c
c
c
b
j
j
j
j
j
m
m
m
m
m
m
m
m
m
m
m
v
v
m
m
m
m
m
m
m
m
m
m
h
m
m
m
m
m
m
m
m
m
m
m
m
m
j
G
c
b
c
c
c
a
a
a
a
"}
(18,1,1) = {"
c
c
c
c
c
c
b
k
k
k
k
k
h
h
h
h
h
h
h
h
h
h
h
v
v
h
h
h
h
h
h
h
h
h
h
h
h
h
h
h
h
h
h
h
h
h
h
h
h
k
H
c
c
c
c
c
a
a
a
a
"}
(19,1,1) = {"
c
c
c
c
c
c
g
k
k
k
k
k
h
h
h
h
h
h
h
h
h
h
h
v
v
h
h
h
h
h
h
h
h
h
h
h
h
h
h
h
h
h
h
h
h
h
h
h
h
k
H
c
c
c
c
c
a
a
a
a
"}
(20,1,1) = {"
c
c
c
c
c
c
g
k
k
k
k
k
h
h
h
h
h
h
h
h
h
h
h
v
v
h
h
h
h
h
h
h
h
h
h
h
h
h
h
h
h
h
h
h
h
h
h
h
h
k
H
c
c
c
c
c
a
a
a
a
"}
(21,1,1) = {"
c
c
c
c
c
c
g
k
k
k
k
k
h
h
h
h
h
h
h
h
h
h
h
v
v
h
h
h
h
h
h
h
h
h
h
h
h
h
h
h
h
h
h
h
h
h
h
h
h
k
H
c
c
c
c
c
a
a
a
a
"}
(22,1,1) = {"
c
c
c
c
c
c
g
k
k
k
k
k
h
h
h
h
h
h
h
h
h
p
q
u
u
y
A
p
h
h
h
h
h
h
h
h
h
h
h
h
h
h
h
h
h
h
h
h
h
k
H
c
c
c
c
c
a
a
a
a
"}
(23,1,1) = {"
c
c
c
c
c
c
g
k
k
k
k
k
h
h
h
h
h
h
h
h
h
q
u
u
u
u
u
C
h
h
h
h
h
h
h
h
h
h
h
h
h
h
h
h
h
h
h
h
h
k
H
c
c
c
c
c
a
a
a
a
"}
(24,1,1) = {"
c
c
c
c
c
c
g
k
k
k
k
k
h
h
h
h
h
h
h
h
h
r
u
u
x
x
u
D
h
h
h
h
h
h
h
h
h
h
h
h
h
h
h
h
h
h
h
h
h
k
H
c
c
c
c
c
a
a
a
a
"}
(25,1,1) = {"
c
c
c
c
c
c
g
k
k
k
k
k
h
h
h
h
h
h
h
h
h
s
u
u
x
x
u
E
h
h
h
h
h
h
h
h
h
h
h
h
h
h
h
h
h
h
h
h
h
k
H
c
c
c
c
c
a
a
a
a
"}
(26,1,1) = {"
c
c
c
c
c
c
g
k
k
k
k
k
h
h
h
h
h
h
h
h
h
r
u
u
x
x
u
D
h
h
h
h
h
h
h
h
h
h
h
h
h
h
h
h
h
h
h
h
h
k
H
c
c
c
c
c
a
a
a
a
"}
(27,1,1) = {"
c
c
c
c
c
c
g
k
k
k
k
k
h
h
h
h
h
h
h
h
h
t
u
u
u
u
u
B
h
h
h
h
h
h
h
h
h
h
h
h
h
h
h
h
h
h
h
h
h
k
H
c
c
c
c
c
a
a
a
a
"}
(28,1,1) = {"
c
c
c
c
c
c
g
k
k
k
k
k
h
h
h
h
h
h
h
h
h
p
t
u
u
z
B
p
h
h
h
h
h
h
h
h
h
h
h
h
h
h
h
h
h
h
h
h
h
k
H
c
c
c
c
c
a
a
a
a
"}
(29,1,1) = {"
c
c
c
c
c
c
g
k
k
k
k
k
h
h
h
h
h
h
h
h
h
h
h
v
v
h
h
h
h
h
h
h
h
h
h
h
h
h
h
h
h
h
h
h
h
h
h
h
h
k
H
c
c
c
c
c
a
a
a
a
"}
(30,1,1) = {"
c
c
c
c
c
c
g
k
k
k
k
k
h
h
h
h
h
h
h
h
h
h
h
v
v
h
h
h
h
h
h
h
h
h
h
h
h
h
h
h
h
h
h
h
h
h
h
h
h
k
H
c
c
c
c
c
a
a
a
a
"}
(31,1,1) = {"
c
c
c
c
c
c
b
k
k
k
k
k
h
h
h
h
h
h
h
h
h
h
h
v
v
h
h
h
h
h
h
h
h
h
h
h
h
h
h
h
h
h
h
h
h
h
h
h
h
k
H
c
b
c
c
c
a
a
a
a
"}
(32,1,1) = {"
c
c
c
c
c
c
b
l
l
l
l
l
i
i
i
i
i
i
i
i
i
i
i
v
v
i
i
i
i
i
i
i
i
i
i
i
i
i
i
i
i
i
i
i
i
i
i
i
i
l
I
c
b
b
c
c
a
a
a
a
"}
(33,1,1) = {"
c
c
c
c
c
c
c
c
c
c
c
c
c
c
c
c
c
c
c
c
c
c
c
c
c
c
c
c
c
c
c
c
c
c
c
c
c
c
c
c
c
c
c
c
c
c
c
c
c
c
c
c
c
c
c
c
a
a
a
a
"}
(34,1,1) = {"
c
c
c
c
c
c
c
c
c
c
c
c
c
c
c
c
c
c
c
c
c
c
c
c
c
c
c
c
c
c
c
c
c
c
c
c
c
c
c
c
c
c
c
c
c
c
c
c
c
c
c
c
c
c
c
c
a
a
a
a
"}
(35,1,1) = {"
c
c
c
c
c
c
c
c
c
c
c
c
c
c
c
c
c
c
c
c
c
c
c
c
c
c
c
c
c
c
c
c
c
c
c
c
c
c
c
c
c
c
c
c
c
c
c
c
c
c
c
c
c
c
c
c
a
a
a
a
"}
(36,1,1) = {"
c
c
c
c
c
c
c
c
c
c
c
c
c
c
c
c
c
c
c
c
c
c
c
c
c
c
c
c
c
c
c
c
c
c
c
c
c
c
c
c
c
c
c
c
c
c
c
c
c
c
c
c
c
c
c
c
a
a
a
a
"}
(37,1,1) = {"
c
c
c
c
c
c
c
c
c
c
c
c
c
c
c
c
c
c
c
c
c
c
c
c
c
c
c
c
c
c
c
c
c
c
c
c
c
c
c
c
c
c
c
c
c
c
c
c
c
c
c
c
c
c
c
c
a
a
a
a
"}
(38,1,1) = {"
c
c
c
c
c
c
c
c
c
c
c
c
c
c
c
c
c
c
c
c
c
c
c
c
c
c
c
c
c
c
c
c
c
c
c
c
c
c
c
c
c
c
c
c
c
c
c
c
c
c
c
c
c
c
c
c
a
a
a
a
"}
(39,1,1) = {"
c
c
c
c
c
c
b
m
m
m
m
m
m
m
m
m
m
m
m
m
m
m
m
m
m
m
m
m
m
m
m
m
m
m
m
m
m
m
m
m
m
m
m
m
m
m
m
m
m
m
m
j
j
b
c
c
a
a
a
a
"}
(40,1,1) = {"
c
c
c
c
c
c
b
h
h
h
h
h
h
h
h
h
h
h
h
h
h
h
h
h
h
h
h
h
h
h
h
h
h
h
h
h
h
h
h
h
h
h
h
h
h
h
h
h
h
h
h
k
k
b
b
a
a
a
a
a
"}
(41,1,1) = {"
c
c
c
c
c
c
b
h
h
h
h
h
h
h
h
h
h
h
h
h
h
h
h
h
h
h
h
h
h
h
h
h
h
h
h
h
h
h
h
h
h
h
h
h
h
h
h
h
h
h
h
k
k
a
b
a
a
a
a
a
"}
(42,1,1) = {"
c
c
c
c
c
c
b
h
h
h
h
h
h
h
h
h
h
h
h
h
h
h
h
h
h
h
h
h
h
h
h
h
h
h
h
h
h
h
h
h
h
h
h
h
h
h
h
h
h
h
h
k
k
a
b
a
a
a
a
a
"}
(43,1,1) = {"
c
c
c
c
c
c
b
h
h
h
h
h
h
h
h
h
h
h
h
h
h
h
h
h
h
h
h
h
h
h
h
h
h
h
h
h
h
h
h
h
h
h
h
h
h
h
h
h
h
h
h
k
k
a
b
b
c
b
b
b
"}
(44,1,1) = {"
b
b
c
b
b
b
b
h
h
h
h
h
h
h
h
h
h
h
h
h
h
h
h
h
h
h
h
h
h
h
h
h
h
h
h
h
h
h
h
h
h
h
h
h
h
h
h
h
h
h
h
k
k
a
b
c
c
c
c
b
"}
(45,1,1) = {"
b
c
c
b
b
b
b
h
h
h
h
h
h
h
h
h
h
h
h
h
h
h
h
h
h
h
h
h
h
h
h
h
h
h
h
h
h
h
h
h
h
h
h
h
h
h
h
h
h
h
h
k
k
a
b
c
c
c
c
b
"}
(46,1,1) = {"
b
c
c
c
c
c
b
h
h
h
h
h
h
h
h
h
h
h
h
h
h
h
h
h
h
h
h
h
h
h
h
h
h
h
h
h
h
h
h
h
h
h
h
h
h
h
h
h
h
h
h
k
k
a
b
c
c
c
c
b
"}
(47,1,1) = {"
b
c
c
c
c
c
b
h
h
h
h
h
h
h
h
h
h
h
h
h
h
h
h
h
h
h
h
h
h
h
h
h
h
h
h
h
h
h
h
h
h
h
h
h
h
h
h
h
h
h
h
k
k
a
b
c
c
c
c
b
"}
(48,1,1) = {"
b
c
c
b
b
b
b
h
h
h
h
h
h
h
h
h
h
h
h
h
h
h
h
h
h
h
h
h
h
h
h
h
h
h
h
h
h
h
h
h
h
h
h
h
h
h
h
h
h
h
h
k
k
a
b
c
c
c
c
b
"}
(49,1,1) = {"
b
c
c
c
c
c
b
h
h
h
h
h
h
h
h
h
h
h
h
h
h
h
h
h
h
h
h
h
h
h
h
h
h
h
h
h
h
h
h
h
h
h
h
h
h
h
h
h
h
h
h
k
k
a
b
c
c
c
c
b
"}
(50,1,1) = {"
b
c
c
b
c
c
b
h
h
h
h
h
h
h
h
h
h
h
h
h
h
h
h
h
h
h
h
h
h
h
h
h
h
h
h
h
h
h
h
h
h
h
h
h
h
h
h
h
h
h
h
k
k
a
b
c
c
c
c
b
"}
(51,1,1) = {"
b
c
c
b
c
c
b
h
h
h
h
h
h
h
h
h
h
h
h
h
h
h
h
h
h
h
h
h
h
h
h
h
h
h
h
h
h
h
h
h
h
h
h
h
h
h
h
h
h
h
h
k
k
a
b
b
c
c
b
b
"}
(52,1,1) = {"
b
c
c
b
b
b
b
h
h
h
h
h
h
h
h
h
h
h
h
h
h
h
h
h
h
h
h
h
h
h
h
h
h
h
h
h
h
h
h
h
h
h
h
h
h
h
h
h
h
h
h
k
k
a
a
b
c
c
b
a
"}
(53,1,1) = {"
b
c
c
b
c
c
b
h
h
h
h
h
h
h
h
h
h
h
h
h
h
h
h
h
h
h
h
h
h
h
h
h
h
h
h
h
h
h
h
h
h
h
h
h
h
h
h
h
h
h
h
k
k
a
b
b
c
c
b
b
"}
(54,1,1) = {"
b
c
c
b
c
c
b
h
h
h
h
h
h
h
h
h
h
h
h
h
h
h
h
h
h
h
h
h
h
h
h
h
h
h
h
h
h
h
h
h
h
h
h
h
h
h
h
h
h
h
h
k
k
a
b
c
M
M
c
b
"}
(55,1,1) = {"
b
c
c
c
c
c
b
h
h
h
h
h
h
h
h
h
h
h
h
h
h
h
h
h
h
h
h
h
h
h
h
h
h
h
h
h
h
h
h
h
h
h
h
h
h
h
h
h
h
h
h
k
k
a
b
c
M
M
c
b
"}
(56,1,1) = {"
b
c
c
b
c
c
b
h
h
h
h
h
h
h
h
h
h
h
h
h
h
h
h
h
h
h
h
h
h
h
h
h
h
h
h
h
h
h
h
h
h
h
h
h
h
h
h
h
h
h
h
k
k
a
b
c
M
M
c
b
"}
(57,1,1) = {"
b
c
c
b
c
c
b
h
h
h
h
h
h
h
h
h
h
h
h
h
h
h
h
h
h
h
h
h
h
h
h
h
h
h
h
h
h
h
h
h
h
h
h
h
h
h
h
h
h
h
h
k
k
a
b
c
M
M
c
b
"}
(58,1,1) = {"
b
c
c
b
c
c
b
h
h
h
h
h
h
h
h
h
h
h
h
h
h
h
h
h
h
h
h
h
h
h
h
h
h
h
h
h
h
h
h
h
h
h
h
h
h
h
h
h
h
h
h
k
k
a
b
c
M
M
c
b
"}
(59,1,1) = {"
b
c
c
b
c
c
b
h
h
h
h
h
h
h
h
h
h
h
h
h
h
h
h
h
h
h
h
h
h
h
h
h
h
h
h
h
h
h
h
h
h
h
h
h
h
h
h
h
h
h
h
k
k
a
b
b
b
b
b
b
"}
(60,1,1) = {"
b
c
c
b
b
b
b
h
h
h
h
h
h
h
h
h
h
h
h
h
h
h
h
h
h
h
h
h
h
h
h
h
h
h
h
h
h
h
h
h
h
h
h
h
h
h
h
h
h
h
h
k
k
a
a
a
a
a
a
a
"}
